................................
#.#.#.#.#.#.#.#.#.#.#.#.#.#.#.#.
................................
#.#.#.#.#.#.#.#.#.#.#.#.#.#.#.#.
................................
#.#.#.#.#.#.#.#.#.#.#.#.#.#.#.#.
................................
#.#.#.#.#.#.#.#.#.#.#.#.#.#.#.#.
...............l.a.............
#.#.#.#.#.#.#.#.#.#.#.#.#.#.#.#.
...............s.c..............
#.#.#.#.#.#.#.#.#.#.#.#.#.#.#.#.
................................
#.#.#.#.#.#.#.#.#.#.#.#.#.#.#.#.
................................
#.#.#.#.#.#.#.#.#.#.#.#.#.#.#.#.
................................
....#.#.#.#.#.#.#.#.#.#.#.#.....