................................
#.#.#.#.#.#.#.#.#.#.#.#.#.#.#.#.
................................
#.#.#.#.#.#.#.#.#.#.#.#.#.#.#.#.
................................
....#.#.#.#.#.#.#.#.#.#.#.#.....
.................r..............
....#.#.#.#.#.#.#.#.#.#.#.#.....
...............a.s..............
....#.#.#.#.#.#.#.#.#.#.#.#.....
...............c................
....#.#.#.#.#.#.#.#.#.#.#.#.....
................................
#.#.#.#.#.#.#.#.#.#.#.#.#.#.#.#.
................................
#.#.#.#.#.#.#.#.#.#.#.#.#.#.#.#.
................................
....#.#.#.#.#.#.#.#.#.#.#.#.....