................................
#.#.#.#.#.#.#.#.#.#.#.#.#.#.#.#.
................................
#.#.#.#.#.#.#.#.#.#.#.#.#.#.#.#.
................................
#.#.#.#.#.#.#.#.#.#.#.#.#.#.#.#.
................................
#.#.#.#.#.#.#.#.#.#.#.#.#.#.#.#.
...............c................
#.#.#.#.#.#.#.#.#.#.#.#.#.#.#.#.
.............s.l.r..............
#.#.#.#.#.#.#.#.#.#.#.#.#.#.#.#.
................................
#.#.#.#.#.#.#.#.#.#.#.#.#.#.#.#.
................................
#.#.#.#.#.#.#.#.#.#.#.#.#.#.#.#.
................................
....#.#.#.#.#.#.#.#.#.#.#.#.....